.     .......
.     .     .
.     .     .
.  .  .  .  .
.     .     .
.     .     .
.......     .
