.............
.#####.#####.
.#.........#.
.............
.#.........#.
.#####.#####.
.............
