... ... .....
. . . . .   .
. . . . . K .
. . . . . . .
. K . . . . .
.   . . . . .
..... ... ...
