.............
.           .
. ......... .
. .       . .
  . K...... .
  .         .
  ...........
